15	15
0 1 0 0 0 0 0 0 0 0 0 0 0 0 0
0 1 1 0 1 0 1 1 1 0 1 1 1 1 0
0 0 1 0 1 1 1 0 1 1 1 0 1 0 0
0 1 1 0 0 1 0 0 0 0 0 0 1 0 0
0 1 0 0 1 1 0 1 1 1 1 0 1 1 0
0 1 1 0 1 0 0 1 0 0 1 0 1 1 0
0 1 0 0 1 0 1 1 1 0 1 1 1 0 0
0 1 0 1 1 0 0 0 0 0 0 0 1 1 0
0 1 0 0 1 0 1 1 1 1 1 1 1 0 0
0 1 1 0 1 0 1 0 0 0 1 0 1 1 0
0 1 0 0 1 1 1 1 0 1 1 0 1 0 0
0 1 1 0 1 1 1 1 0 1 1 0 1 1 0
0 1 0 0 1 0 1 0 0 0 1 0 1 1 0
0 1 1 1 1 0 1 1 1 1 1 0 1 1 0
0 0 0 0 0 0 0 0 0 0 0 0 0 0 0
7	6
4
1	0
12	2
11	8
2	13
8
2	1	2	3	6
3	6	3	1	6
2	8	0	1	6
3	10	3	1	6
1	8	10	4	14
1	8	11	4	14
1	11	10	4	14
1	11	11	4	14
10
4	1
13	1
4	2
2	5
7	8
9	8
2	9
2	11
7	13
9	13