15	15
0 0 0 0 0 0 0 0 0 0 0 0 0 0 0
0 1 1 1 1 1 1 1 0 1 1 1 1 1 0
0 1 0 1 0 0 0 1 0 1 0 0 0 1 0
0 1 0 0 0 1 0 1 0 1 0 1 1 1 0
0 1 1 1 1 1 0 1 0 1 0 1 1 1 0
0 0 0 0 0 1 0 1 1 1 0 0 0 1 0
0 1 1 1 1 1 0 0 1 1 0 1 1 1 0
0 1 1 1 0 1 1 0 1 1 0 1 1 1 0
0 0 0 1 0 0 1 0 0 0 0 1 0 0 0
0 1 1 1 1 0 1 1 1 0 1 1 1 1 0
0 1 0 0 1 0 0 0 1 0 0 0 0 1 0
0 1 1 0 1 1 1 0 1 1 1 1 0 1 0
0 0 1 0 0 0 1 0 0 0 0 1 0 1 0
0 1 1 1 1 0 1 1 1 1 1 1 1 1 0
0 0 0 0 1 0 0 0 0 0 0 0 0 0 0
6	7
5
4	14
11	12
13	12
9	2
1	2
15
0	0	13	1	12
0	0	7	1	1
0	0	6	1	8
0	5	13	4	8
1	14	9	2	6
1	14	7	1	6
0	10	6	1	6
0	10	4	1	6
1	14	3	1	6
1	14	1	3	6
3	8	8	2	6
1	8	1	4	8
0	0	4	3	6
1	7	8	1	1
1	9	9	1	1
8
3	2
5	3
7	5
13	5
3	8
11	8
8	10
8	11