12	12
0 1 0 0 0 0 0 0 0 0 0 0
0 1 1 1 1 1 1 1 1 1 1 0
0 1 0 0 0 0 0 0 1 0 0 0
0 1 0 1 1 1 1 1 1 1 1 0
0 1 0 1 0 0 0 0 0 0 0 0
0 1 0 1 0 1 1 1 1 1 1 0
0 1 0 1 0 0 0 0 0 0 1 0
0 1 1 1 1 1 1 1 0 1 1 0
0 1 0 0 0 0 0 0 0 1 0 0
0 1 0 1 1 1 1 1 1 1 1 0
0 1 1 1 0 1 0 1 0 0 1 0
0 0 0 0 0 0 0 0 0 0 0 0
5	5
2
1	0
10	10
1
0	2	9	5	15
5
10	1
10	3
9	7
5	10
7	10