15	15
0 0 0 0 0 0 0 0 0 0 0 0 0 0 0
0 1 1 1 1 1 1 0 1 0 1 1 1 1 0
0 1 0 1 0 1 0 0 1 0 1 0 0 1 0
0 1 0 1 0 1 0 1 1 1 1 1 0 1 0
0 1 0 1 0 1 0 1 0 0 0 0 0 1 0
0 1 1 1 0 1 1 1 0 1 1 1 1 1 0
0 1 0 1 0 0 0 0 0 1 0 0 0 1 0
0 1 0 1 1 0 1 1 0 1 1 1 0 0 0
0 1 0 1 1 0 1 0 0 0 0 1 1 1 0
0 1 1 1 1 0 1 1 1 1 0 0 0 1 1
0 1 0 0 0 0 0 0 0 1 1 1 0 0 0
0 1 1 0 1 1 1 1 1 1 0 1 1 1 0
0 0 1 0 1 1 1 1 1 1 0 1 1 1 0
0 1 1 1 1 1 1 1 1 1 1 1 1 1 0
0 0 0 0 0 0 0 0 0 0 0 0 0 0 0
7	7
5
14	9
13	4
5	2
3	13
7	9
13
1	14	8	2	6
0	8	5	3	9
2	10	0	2	6
2	8	0	2	6
1	7	1	2	6
2	3	0	3	9
0	3	11	1	3
0	3	12	1	3
1	14	11	2	6
1	14	12	2	6
3	6	10	2	6
0	0	6	1	3
0	0	7	1	3
8
9	3
11	3
2	5
13	6
2	9
10	10
1	13
13	13