15	15
0 0 0 0 0 0 0 0 0 0 0 0 0 0 0
0 1 1 1 1 1 0 1 1 1 1 1 1 1 0
0 1 0 1 0 1 1 1 1 1 1 1 1 1 0
0 1 1 1 1 1 1 1 0 0 0 0 0 1 0
0 1 0 1 0 1 0 0 0 1 1 1 1 1 0
0 1 1 1 1 1 0 1 1 1 1 1 1 1 0
0 1 0 0 0 0 0 1 1 1 1 1 1 1 0
0 1 1 1 0 1 1 1 1 1 1 1 1 1 0
0 0 0 1 0 0 0 1 1 1 1 1 1 1 0
0 1 1 1 0 1 0 1 1 1 1 1 1 1 0
0 1 0 1 1 1 1 1 0 1 1 1 1 1 1
0 1 0 0 1 0 1 0 0 0 0 0 0 1 0
0 1 1 0 0 0 0 0 1 1 1 1 1 1 0
0 1 1 1 1 1 1 1 1 1 1 1 1 1 0
0 0 0 0 0 0 0 0 0 0 0 0 0 0 0
5	7
4
14	10
7	3
7	13
3	9
20
2	1	0	3	9
1	5	0	3	9
2	8	0	1	9
2	10	0	1	9
2	12	0	1	9
3	9	3	1	9
3	11	3	1	9
2	10	3	1	1
0	0	5	3	9
3	5	6	3	9
0	2	10	1	6
2	2	11	1	6
2	8	11	1	9
3	9	11	1	1
2	10	11	1	9
3	1	14	2	9
3	9	14	1	9
3	11	14	1	9
1	6	1	3	6
3	11	11	1	1
10
7	1
3	2
7	2
2	3
4	3
3	4
4	11
6	11
4	13
5	13